2222222222
2111111112
2121111212
2121111212
2111221112
2121112112
2112221112
2111111112
2111111112
2222222222